#currencyCode=flagName

USD=us
CAD=ca
MXN=mx
BRL=br
ARS=ar
CLP=cl
COP=co
PEN=pe
UYU=uy
VEF=ve
BOB=bo
PYG=py
CRC=cr
GTQ=gt
HNL=hn
NIO=ni
PAB=pa
DOP=dop
JMD=jm
TTD=tt
BBD=bb
BSD=bs
BZD=bz
XCD=ag
GBP=gb
EUR=eu
CHF=ch
SEK=se
NOK=no
DKK=dk
PLN=pl
CZK=cz
HUF=hu
RON=ro
BGN=bg
HRK=hr
RUB=ru
TRY=tr
ISK=is
UAH=ua
XPF=pf
BAM=ba
MKD=mk
RSD=rs
ALL=al
MDL=md
GEL=ge
BYN=by
JPY=jp
CNY=cn
HKD=hk
SGD=sg
KRW=kr
TWD=tw
INR=in
IDR=id
MYR=my
PHP=ph
THB=th
VND=vn
PKR=pk
BDT=bd
LKR=lk
NPR=np
MMK=mm
KHR=kh
LAK=la
BND=bn
MOP=mo
KPW=kp
MNT=mn
KZT=kz
UZS=uz
TJS=tj
KGS=kg
TMT=tm
AFN=af
AZN=az
AMD=am
AUD=au
NZD=nz
FJD=fj
PGK=pg
SBD=sb
VUV=vu
WST=ws
TOP=to
SAR=sa
AED=ae
KWD=kw
QAR=qa
BHD=bh
OMR=om
JOD=jo
ILS=il
LBP=lb
SYP=sy
IQD=iq
IRR=ir
YER=ye
NIS=il
ZAR=za
EGP=eg
NGN=ng
KES=ke
GHS=gh
TZS=tz
UGX=ug
MAD=ma
TND=tn
DZD=dz
LYD=ly
ETB=et
AOA=ao
MZN=mz
ZMW=zm
BWP=bw
NAD=na
SZL=sz
LSL=ls
MWK=mw
RWF=rw
BIF=bi
XOF=sn
XAF=cm
GMD=gm
SLL=sl
LRD=lr
CDF=cd
SDG=sd
SOS=so
DJF=dj
ERN=er
MRU=mr
CVE=cv
STN=st
SCR=sc
MUR=mu
KMF=km
MGA=mg
BTC=btc
ANG=ang